GGGGGGGGGGGGGGGGGGGGGGG
GGGGGGGGGGGGGGGGGGGGGGG
GG1111111111111111111GG
GG1PPPPPPPPAPPPPPPPP1GG
GG1P@HHPH#PAP@HPHH#P1GG
GG1PAPPPPAPOPAPPPPAP1GG
GG1PPPH#PAPAPAP@HPPP1GG
GG1PAPPAPAPOPAPAPPAP1GG
GG1P!HPAPAPAPAPAPH$P1GG
GG1PPPPPBBBBBBBPPPPP1GG
GG1PHHHHB@HBH#BHHHHP1GG
GG1PPPPPBABBBABPPPPP1GG
GG1PHHHHB!HHH$BHHHHP1GG
GG1PPPPPBBBBBBBPPPPP1GG
GG1P@HPAPAPAPAPAPH#P1GG
GG1PAPPAPAPOPAPAPPAP1GG
GG1PPPH$PAPAPAP!HPPP1GG
GG1PAPPPPAPOPAPPPPAP1GG
GG1P!HPHH$PAP!HHPH$P1GG
GG1PPPPPPPPAPPPPPPPP1GG
GG1111111111111111111GG
GGGGGGGGGGGGGGGGGGGGGGG
GGGGGGGGGGGGGGGGGGGGGGG