!!!!!!!!!!!!!!!!!!!!!!!
!!!!!!!!!!!!!!!!!!!!!!!
!!!!!!!!!!!!!!!!!!!!!!!
!!!HHHHHHHHHHHHHHHHH!!!
!!!HHHHHHHHHHHHHHHHH!!!
!!!HHHHHHHHHHHHHHHHH!!!
!!!HHHHHHHHHHHHHHHHH!!!
!!!HHHHHHHHHHHHHHHHH!!!
!!!HHHHHHHHHHHHHHHHH!!!
!!!HHHHHIIIIIIIHHHHH!!!
!!!HHHHHI!!!!!IHHHHH!!!
!!!HHHHHI!!!!!IHHHHH!!!
!!!HHHHHI!!!!!IHHHHH!!!
!!!HHHHHIIIIIIIHHHHH!!!
!!!HHHHHHHHHHHHHHHHH!!!
!!!HHHHHHHHHHHHHHHHH!!!
!!!HHHHHHHHHHHHHHHHH!!!
!!!HHHHHHHHHHHHHHHHH!!!
!!!HHHHHHHHHHHHHHHHH!!!
!!!HHHHHHHHHHHHHHHHH!!!
!!!!!!!!!!!!!!!!!!!!!!!
!!!!!!!!!!!!!!!!!!!!!!!
!!!!!!!!!!!!!!!!!!!!!!!