GGGGGGGGGGGGGGGGGGGGGGG
GGGGGGGGGGGGGGGGGGGGGGG
GG1111111111111111111GG
GG1PPPPPPPPPPPPPPPPP1GG
GG1PPPPPPPPPPPPPPPPP1GG
GG1PPPPPPPPPPPPPPPPP1GG
GG1PPPPPPPPPPPPPPPPP1GG
GG1PPPPPPPPPPPPPPPPP1GG
GG1PPPPPPPPPPPPPPPPP1GG
GG1PPPPPBBBBBBBPPPPP1GG
GG1PPPPPB@HBH#BPPPPP1GG
GG1PPPPPBABBBABPPPPP1GG
GG1PPPPPB!HHH$BPPPPP1GG
GG1PPPPPBBBBBBBPPPPP1GG
GG1PPPPPPPPPPPPPPPPP1GG
GG1PPPPPPPPPPPPPPPPP1GG
GG1PPPPPPPPPPPPPPPPP1GG
GG1PPPPPPPPPPPPPPPPP1GG
GG1PPPPPPPPPPPPPPPPP1GG
GG1PPPPPPPPPPPPPPPPP1GG
GG1111111111111111111GG
GGGGGGGGGGGGGGGGGGGGGGG
GGGGGGGGGGGGGGGGGGGGGGG