GGGGGGGGGGGGGGGGGGGGGGG
GGGGGGGGGGGGGGGGGGGGGGG
GG1111111111111111111GG
GG1PPPPPPPPAPPPPPPPP1GG
GG1P@#P@H#PAP@H#P@#P1GG
GG1P!$PABAPAPABAP!$P1GG
GG1PPPO!H$PAP!H$OPPP1GG
GG1P@H#PPPPPPPPP@H#P1GG
GG1PABAPHHHHHHHPABAP1GG
GG1P!H$PBBBBBBBP!H$P1GG
GG1PPPPAB@HBH#BAPPPP1GG
GG1PHHPABABBBABAPHHP1GG
GG1PPPPAB!HHH$BAPPPP1GG
GG1P@H#PBBBBBBBP@H#P1GG
GG1PABAPHHHHHHHPABAP1GG
GG1P!H$PPPPPPPPP!H$P1GG
GG1PPPO@H#PAP@H#OPPP1GG
GG1P@#PABAPAPABAP@#P1GG
GG1P!$P!H$PAP!H$P!$P1GG
GG1PPPPPPPPAPPPPPPPP1GG
GG1111111111111111111GG
GGGGGGGGGGGGGGGGGGGGGGG
GGGGGGGGGGGGGGGGGGGGGGG