GGGGGGGGGGGGGGGGGGGGGGG
GGGGGGGGGGGGGGGGGGGGGGG
GG8333333333333333337GG
GG2PPPPPPPPAPPPPPPPP4GG
GG2OHHPHHHPAPHHHPHHO4GG
GG2IPPIPIPIPIPIPIPPI4GG
GG2PHHPAPHH&HHPAPHHP4GG
GG2PPPIAPPPAPPPAIPPP4GG
GG2HH#P%HHPAPHH^P@HH4GG
GG2BBAPABBiBiBBAPABB4GG
GG2HH$PAB@HBH#BAP!HH4GG
GG2BBBIBiABBBAiBIBBB4GG
GG2HH#PAB!HHH$BAP@HH4GG
GG2BBAPABBiBiBBAPABB4GG
GG2HH$P%HHPAPHH^P!HH4GG
GG2PPPIAPPPAPPPAIPPP4GG
GG2PHHPAPHH*HHPAPHHP4GG
GG2IPPIPIPIPIPPPIPPI4GG
GG2OHHPHHHPAPHHHPHHO4GG
GG2PPPIPPPPAPPPPIPPP4GG
GG5111111111111111116GG
GGGGGGGGGGGGGGGGGGGGGGG
GGGGGGGGGGGGGGGGGGGGGGG