GGGGGGGGGGGGGGGGGGGGGGG
GGGGGGGGGGGGGGGGGGGGGGG
GG1111111111111111111GG
GG1BAAPPPPPPPPPPPAAB1GG
GG1B!$PHH&HHH&HHP!$B1GG
GG1PIPPPPAPOPAPPPPIP1GG
GG1HPHH#PAPAPAP@HHPH1GG
GG1PIPPAIPPAPPIAPPIP1GG
GG1P@#PAPHH*HHPAP@#P1GG
GG1P!$PAiBBBBBiAP!$P1GG
GG1PPPPPB@HBH#BPPPPP1GG
GG1OHHHPH^BBB%HPHHHO1GG
GG1PPPPPB!HHH$BPPPPP1GG
GG1P@#PAiBBBBBiAP@#P1GG
GG1P!$PAPHH&HHPAP!$P1GG
GG1PPPPAPPPAPPPAPPPP1GG
GG1HPHH$PAPAPAP!HHPH1GG
GG1PPPPPPAPOPAPPPPPP1GG
GG1B@#PHH*HHH*HHP@#B1GG
GG1BAAPPPPPPPPPPPAAB1GG
GG1111111111111111111GG
GGGGGGGGGGGGGGGGGGGGGGG
GGGGGGGGGGGGGGGGGGGGGGG